{
    "tiles" : [[1, 1, 1, 1, 1, 1, 1, 1, 1 ],
               [1, 0, 0, 1, 1, 1, 0, 0, 1 ],
               [1, 0, 0, 1, 1, 1, 0, 0, 1 ],
               [1, 1, 1, 1, 1, 1, 1, 1, 1 ],
               [1, 1, 1, 1, 1, 1, 1, 1, 1 ],
               [1, 1, 1, 1, 1, 1, 1, 1, 1 ],
               [1, 0, 0, 1, 1, 1, 0, 0, 1 ],
               [1, 0, 0, 1, 1, 1, 0, 0, 1 ],
               [1, 1, 1, 1, 1, 1, 1, 1, 1 ] ],
    
    "targetScore" : 4000,
    "moves" : 30,
}
