{
    "tiles" : [[1, 1, 1, 1, 1, 1, 1, 1, 1 ],
               [1, 1, 1, 1, 1, 1, 1, 1, 1 ],
               [1, 1, 2, 2, 2, 2, 2, 1, 1 ],
               [1, 1, 2, 1, 1, 1, 2, 1, 1 ],
               [1, 1, 2, 1, 1, 1, 2, 1, 1 ],
               [1, 1, 2, 1, 1, 1, 2, 1, 1 ],
               [1, 1, 2, 2, 2, 2, 2, 1, 1 ],
               [1, 1, 1, 1, 1, 1, 1, 1, 1 ],
               [1, 1, 1, 1, 1, 1, 1, 1, 1 ] ],
    
    "targetScore" : 16,
    "moves" : 25,
}
