{
    "tiles" : [[1, 1, 1, 1, 1, 1, 1, 1, 1 ],
               [1, 2, 1, 2, 1, 2, 1, 2, 1 ],
               [1, 1, 1, 1, 1, 1, 1, 1, 1 ],
               [1, 2, 1, 1, 1, 1, 1, 2, 1 ],
               [1, 1, 1, 2, 1, 2, 1, 1, 1 ],
               [1, 2, 1, 1, 1, 1, 1, 2, 1 ],
               [1, 1, 1, 1, 1, 1, 1, 1, 1 ],
               [1, 2, 1, 2, 1, 2, 1, 2, 1 ],
               [1, 1, 1, 1, 1, 1, 1, 1, 1 ] ],
    
    "targetScore" : 14,
    "moves" : 50,
}